----------------------------------------------------------------------------------------------------------------------------------------------------------------------------------------------------------
----------------------------------------------------------------------------------------------------------------------------------------------------------------------------------------------------------
----------------------------------------------------------------------------------------------------------------------------------------------------------------------------------------------------------
----------------------------------------------------------------------------------------------------------------------------------------------------------------------------------------------------------
----------------------------------------------------------------------------------------------------------------------------------------------------------------------------------------------------------
----------------------------------------------------------------------------------g-----------------------------------------------------------------------------------------------------------------------
-----------------------------------------------------------------------------------------------------@-----------SSS----S!!S--------------------------------------------------------##--------------------
-------------------------------------------------------------------------------------------------------------------------------------------------------------------------------------------###------------
-------------------------------------------------------------------------------g----------------------------------------------------------------------------------------------------------####------------
------------------------------------------------------------------------------------------------------------------------------------------------------------------------------------------#####-----------
---------------------------------------------------------------------------------------------------------------------------------SS------#--#----------##--#------------SS!S------------######------------
----------------------------------------------------------------------------------------------------------------------------------------##--##--------###--##--------------------------#######------------
---------------------------------------------------------------------------------------------------------------------------------------###--###------####--###-----tt--------------tt-########--------F---
---M--------------------k----------g--------g--------g-g---------------------------------------g-g--------k-----------------gg-g-g----####--####----#####--####----tt---------gg---tt#########--------#---
XXXXXXXXXXXXXXXXXXXXXXXXXXXXXXXXXXXXXXXXXXXXXXXXXXXXXXXXXXXXXXXXXXXXXXXXXXXXXXXXXXXXXXXXXXXXXXXXXXXXXXXXXXXXXXXXXXXXXXXXXXXXXXXXXXXXXXXXXXXXXXXXXXXXXXXXX--XXXXXXXXXXXXXXXXXXXXXXXXXXXXXXXXXXXXXXXXXXXXXXX
XXXXXXXXXXXXXXXXXXXXXXXXXXXXXXXXXXXXXXXXXXXXXXXXXXXXXXXXXXXXXXXXXXXXXXXXXXXXXXXXXXXXXXXXXXXXXXXXXXXXXXXXXXXXXXXXXXXXXXXXXXXXXXXXXXXXXXXXXXXXXXXXXXXXXXXXX--XXXXXXXXXXXXXXXXXXXXXXXXXXXXXXXXXXXXXXXXXXXXXXX